  0 1 2 3 4 5 6 7 8 9 0 1 2 3 4
0 # # # # # # # # # # # # # # # 
1 S   #     G # T #   #       #
2 #   # # #   # T #   # # # L #
3 #             G #   #   #   #
4 # # #   # # # # #   #   #   #
5 #           #   #   #     G #
6 #   # # #   #   #   # # #   #
7 #     T #   #       #       #
8 #   #   #   #   #   #   #   #
9 #   #   #   #   #   #   #   #
0 #   #   #   # G #   # # #   #
1 #   # T # T   B #     G     #
2 #   # # # # # # #   # # # # #
3 #               #           E
4 # # # # # # # # # # # # # # #